#################
#S   ##     #####
# ###    #  #  E#
#        ###    #
####  ###       #
#         #######
#################

