############################
#S         ##    ####     ##
### ########  #     ### ##E#
#   #        #### # ####   #
#   # ## #### ## # #### # ##
### # ##   ## ## #     #   #
#     ## ## ## ### ## ######
#   ##  ## ##   # ## ##     #
### ## ## ## # # ## ## #### #
#     ##    ## # ## ##     ##
#   ### ##### # ## # #######
#     ##       # ##   ##   #
## ## # ###### # ## ### ## #
#      #### #  #         ###
# #####    ## ####### ### ##
# ##### ## # ##           ##
# ## ## ## # ## #### #### ##
#     ## ## ##   ##     # ##
### ### ## ## ##### ## ##E##
# #         ##      #    ####
# ### # ##  ##### ###########
#     # ##        #   #######
#   # # ### ## ### ##   ## #
# ###### ## ##     ## # ## #
#      ## ## ## ####### ## #
#### #### ## ## #   #     ###
#     ## ## ## ## # #### ##E#
############################