#########################
#S      #     ###########
##### ### ###    ########
#   #      ####  #   E##
# # # #####     ## ######
# #   ###  ## ###    ####
### ###      ## ## ## ###
# #         ##     ## ###
# ## #  ###### ## ### ###
#              #        #
########################
