#############
#############
## S  #    ##
## ## # ## ##
## ## # ## ##
## ##   ## ##
##    #     E	
#############