########################################
#S## ##                 ##   ## ##     #
# ## ##  ### ####### #####    ## ## ####
# #        #   # # # #            ##   #
# ####   ##### # # # #  ##### ### ## # #
#    ## ##      #  # #  ##    ## ##    #
## ## # # # #### #   # #### ## ### #####
#  #    # # ## ## ###   ##         ##  #
#  # ## ##  #          ## ####  # ## ###
# ## # ##  #  ### ## #### ## ## ## #####
# ## ## ## ## ## ## ## ## ## ## ## ##E#
# ## ## ## ## ## ## ## ## ## ## ## ## ##
# ## ## ## ## ## ## ## ## ## ## ## ## ##
# ## ## ## ## ## ## ## ## ## ## ## ## ##
#    ## ##    ## ## ##                 #
########################################